#######################################
#   #   E #        #####  #     #     #
# ### #  ####     #   #  #  ### #     #
#     #    k####    #  G  #     D#  H #
# # #####     ######      #######  ####
# #      ####            #         #X##
# ####      ####   #######  ####  #  ##
#     #########     #     #      #   ##
###              ##########    ########
#    #    #     #      #   ##     #  ##
#######################################
