#######################################
#     #    k####    #  G        D   H #
# ### #  ####     #   #  #  ### #     #
#   #     #        #####  #     #     #
# # #####     ######      #######  ####
# #      ####            #         #X##
# ####      ####  E#######  ####  #  ##
#     #########     #     #          ##
###              ##########    ########
#    #    #     #      #   ##     #  ##
#######################################
