#######################################
#   #     #        #####  #     #     #
# ### #  ####     #   #  #  ### #     #
#     #    k####    #  G  #     D#  H #
# # #####     ######      #######  ####
# #      ####            #         #X##
# ####      ####   #######  ####  #  ##
#     #########     #     #      #   ##
###              ##########    ########
#    #    #     #      #   ##     #  ##
#######################################
