#######################################
#     #     ####    #  G        D   H #
# ### #  ####     #   #  #  ### #     #
#   #     #        #####  #     #     #
# # #####     ######      #######  ####
#        ####            #         #X##
# ####     k####  E#######  ####  #  ##
#     #########     #     #          ##
###              ##########    ########
#    #    #     #      #   ##     #  ##
#######################################
